17
10
XXXXX############
XXXXX####      ##
XXXXX####  #$ ###
#########     ###
##########    ###
######### $ # ###
# . .     $  $  #
##. .    $  $@  #
# . .  ##########
########XXXXXXXXX
#       