9
7
 #####   
###  ####
#     $ #
# #  #$ #
# . .#@ #
#########
   ##    
