19
14
XXXX###############
XXXX########      #
############  $   #
# .  #   .$       #
# $.$#$    #  .   #
#          #  . * #
#    #     ########
#    #  $. ########
## ################
#    #    #####XXXX
#         #####XXXX
#    #    @####XXXX
#    #    #####XXXX
###############XXXX

