10
12
########X#
### ..@###
### $$ ###
#### #####
#### #####
#### #####
#### #####
#    #####
# #   ####
#   # ##XX
###   ##XX
########XX
